111111111111111111111111111111111111111111111111
100000000001000000100000000000000001000100000001
100000000001000000100000000000000001000100000001
100000000001000000100000000000000001000100000001
100000000001000000000000000000000000000100000001
100000000001000000000000000000000000000100000001
100000000001000000100000000000000001000100000001
100000000001000000100000000000000001000100000001
100000000001000000111111111111111111000100000001
100000000001000000000000000000000000000100000001
111111111001000000000000000000000000000111111001
100000000000000000000000000000000000000000000001
100000000000000000000000000000000000000000000001
100000000000000000000000000000000000000000000001
100000000000000000000000000000000000000000000001
100000000000000000000000000000000000000000000001
111111111111111111100011111111111111111111111001
100000000000000000000000000000000000001000000001
100000000000000000000000000000000000001000000001
100000000000000000000000000000000000001000000001
100000000000000000000000000000000000001000000001
100000000000000000000000000000000000001000000001
100000000000000000000000000000000000001000000001
100000000000000000000000000000000000001000000001
100000000000000000000000000000000000001000000001
100000000000000000000000000000000000001000000001
111111111111111111111111111111111111111111111111