111111111111111111111111111111111111111111111111
100000010000000000000000000000000000000000000001
100000010000000000000000000000000000000000000001
100000010000000000000000000000000000000000000001
100000010000000000000000000000000000000000000001
100000010000000000000000000000000000000000000001
100000010000000000000000000000000000000000000001
100000010000000000000000000000000000000000000001
100000010000000000000000000000000000000000000001
100000010000000000000000000000000000000000000001
100000010000000000000000000000000000000000000001
100000010000000000000000000000000000000000000001
100000010000000000000000000000000000000000000001
111001110000000000000000000000000000000000000001
100000010000000000000000000000000000000000000001
100000010000000000000000000000000000000000000001
100000010000000000000000000000000000000000000001
100000010000000000000000000000000000000000000001
100000010000000000000000000000000000000000000001
100000010000000000000000000000000000000000000001
100000010000000000000000000000000000000000000001
100000000000000000000000000000000000000000000001
100000000000000000000000000000000000000000000001
100000000000000000000000000000000000000000000001
100000010000000000000000000000000000000000000001
100000010000000000000000000000000000000000000001
111111111111111111111111111111111111111111111111