111111111111111111111111111111111111111111111111
100001000000000000000010000000100000000000000001
100001000000000000000010000000100000000000000001
100001000000000000000010000000100000000000000001
100001000000000000000010001000100000000000000001
100001000000000000000010001000100000000000000001
100001000000000000000010001000100000000000000001
100001000000000000000010001000100000000000000001
100001000000000000000010001000100000000000000001
100001000000000000000010001000100000000000000001
110011111001110001111110001000100000000000000001
100000000000010000000010001000100000000000000001
100000000000010000000010001000100000000000000001
100000000000010000000010001000100000000000000001
100000000000010000000010001000100000000000000001
100000000000010000000010001000111001111111110011
100000000000010000000010001000100000001000000001
100000000000010000000010001000100000001000000001
100000000000010000000010001000100000001000000001
100000000000010000000010001000100000001000000001
100000000000010000000010001000100000000000000001
100000000000010000000010001000100000000000000001
100000000000000000000010001000100000001000000001
100000000000000000000010001000100000001000000001
100000000000010000000000001000000000001000000001
100000000000010000000000001000000000001000000001
111111111111111111111111111111111111111111111111